gog - Gog
steam - Steam
psn - Psn
xboxone - XBoxOne
generic - Generic
origin - Origin
uplay - Uplay
battlenet - Battlenet
epic - Epic
bethesda - Bethesda
paradox - ParadoxPlaza
humble - HumbleBundle
kartridge - Kartridge
itch - ItchIo
nswitch - NintendoSwitch
nwiiu - NintendoWiiU
nwii - NintendoWii
ncube - NintendoGameCube
riot - RiotGames
wargaming - Wargaming
ngameboy - NintendoGameBoy
atari - Atari
amiga - Amiga
snes - SuperNintendoEntertainmentSystem
beamdog - Beamdog)
d2d - Direct2Drive
discord - Discord
dotemu - DotEmu
gamehouse - GameHouse
gmg - GreenManGaming
weplay - WePlay
zx - ZxSpectrum
vision - ColecoVision
nes - NintendoEntertainmentSystem
sms - SegaMasterSystem
c64 - Commodore64
pce - PcEngine
segag - SegaGenesis
neo - NeoGeo
sega32 - Sega32X
segacd - SegaCd
3do - _3Do
saturn - SegaSaturn
psx - PlayStation
ps2 - PlayStation2
n64 - Nintendo64
jaguar - AtariJaguar
dc - SegaDreamcast
xboxog - Xbox
amazon - Amazon
gg - GamersGate
egg - Newegg
bb - BestBuy
gameuk - GameUk
fanatical - Fanatical
playasia - PlayAsia
stadia - Stadia
arc - Arc
eso - ElderScrollsOnline
glyph - Glyph
aionl - AionLegionsOfWar
aion - Aion
blade - BladeAndSoul
gw - GuildWars
gw2 - GuildWars2
lin2 - Lineage2
ffxi - FinalFantasy11
ffxiv - FinalFantasy14
totalwar - TotalWar
winstore - WindowsStore
elites - EliteDangerous
star - StarCitizen
psp - PlayStationPortable
psvita - PlayStationVita
nds - NintendoDs
3ds - Nintendo3Ds
pathofexile - PathOfExile
twitch - Twitch
minecraft - Minecraft
gamesessions - GameSessions
nuuvem - Nuuvem
fxstore - FXStore
indiegala - IndieGala
playfire - Playfire
oculus - Oculus
test - Test
rockstar - Rockstar)])
